sale_date	销售日期
class_id	车型ID
sale_quantity	销量
brand_id	品牌ID
compartment	厢数
type_id	车型类别ID
level_id	车型级别ID
department_id	车型系别ID
TR	变速器档位
gearbox_type	变速器形式
displacement	排量
if_charging	是否增压
price_level	成交段
driven_type_id	驱动形式ID
fuel_type_id	燃料种类ID
newenergy_type_id	新能源类型ID
emission_standards_id	排放标准ID
if_MPV_id	是否微客MPV
if_luxurious_id	是否豪华ID
power	功率
cylinder_number	缸数
engine_torque	发动机扭矩
car_length	车长
car_width	车宽
car_height	车高
total_quality	总质量
equipment_quality	整备质量
rated_passenger	额定载客
wheelbase	轴距
front_track	前轮距
rear_track	后轮距
